	[Common]
Invalid exe	Не верный файл H3WMAPED.exe
"%s" is invalid	"%s" поврежден
"%s" not found	"%s" не найден
"%s" is missing or incorrect	"%s" отсутствует или поврежден
"%s" is not a valid positive integer	"%s" - не натуральное число
Advanced Properties Menu	Дополнительные свойства...
WoG Tools	Опции WoG
Exception Question	
Вы хотите сохранить карту перед завершением программы?
(Нажмите Отмена чтобы продолжить работу)
Unbind All Question	Вы уверены, что хотите отвязать все события от файлов скриптов?
Save Map Filter	Файл карт для Героев 3 WoG (*.h3m)|*.h3m|Файл карт для Героев 3 SoD (*.h3m)|*.h3m|All Files (*.*)|*.*|
Validation: Enter Overlap	"Перекрытие входа в (%d, %d, %d)"
Вход одного объекта перекрывается с другим объектом. Это может привести к багам в игре.


	[Advanced Properties]
StdPropsText	Стандартные свойства
NoStdPropsText	Стандартных свойств нет
Caption	Дополнительные свойства
RSSpeedButton1.Hint	Опция не поддерживается
RSSpeedButton2.Hint	Копировать
RSSpeedButton3.Hint	Вставить
Label1.Caption	Тип:
Label2.Caption	Подтип:
Label3.Caption	Рисунок:
Label13.Caption	Все
CheckNone.Hint	Отключить все
CheckAll.Hint	Включить все
Label6.Caption	Пусто
Label8.Caption	Объект
Label9.Caption	Вход
CheckBox1.Caption	Часть почвы
Button1.Caption	ОК
Button2.Caption	Отмена
Button3.Caption	Справка

	[Events Binding]
BindText	Привязать
UnbindText	Отменить связывание
BindHint	Связать с файлом скрипта
RSSpeedButton1.Hint	Открыть...
RSSpeedButton2.Hint	Редактировать
Label2.Caption	Файл скрипта:
BoundAutorefresh	Событие привязано к Файлу скрипта.
При каждом сохранении карты подставляется новая версия скрипта.
Карта пересохраняется после каждого изменения файла скрипта. Подробнее см. Справку.
BoundNoAutorefresh	Событие привязано к Файлу скрипта.
При каждом сохранении карты подставляется новая версия скрипта.
Если Вы включите Автосохранение скриптов, Вам не придется пересохранять карту после изменения скрипта. Подробнее см. Справку.
OpenDialog1.Title	Привязать к

	[WoG Button Bar]
RSSpeedButton1.Hint	Загрузить картинку миникарты
RSSpeedButton2.Hint	Сохранить картинку миникарты
ButtonSingleSquares.Hint	Разрешить одиночные клетки
RSSpeedButton4.Hint	Залить карту
ButtonExpandRoads.Hint	Продолжать дороги за край карты
ButtonRoads1.Hint	Ставить дороги и реки где угодно
OpenPictureDialog1.PreviewButton.Hint	Увеличить
SavePictureDialog1.PreviewButton.Hint	Увеличить
ButtonCopyMap.Hint	Копировать часть карты
ButtonPasteMap.Hint	Вставить часть карты

	[CopyMap Bar]
RSSpeedButton1.Caption	Отмена
ButtonGround.Hint	Вставить почву
ButtonObjects.Hint	Поставить объекты
LabelCopy1.Caption	Выберите верхний левый угол прямоугольника для копирования.
LabelCopy2.Caption	Выберите нижний правый угол прямоугольника для копирования.
LabelPaste.Caption	Выберете место, куда будет постевлен верхний-левый угол скопированной области.
LabelCopyCaption.Caption	Копировать часть карты
LabelPasteCaption.Caption	Вставить часть карты
